TCS	Tcs Group Holding
TCS	The Chennai Silks
Tcs Group Holding	The Chennai Silks
International Business Machines Corp	IBM
Oracle Corporation	Oracle
Dominos Pizza	Dominoâ€™s
PepsiCo	PEPSI-COLA METROPOLITAN BOTTLING COMPANY, INC.
Procter & Gamble	The Procter & Gamble Co
Philips	Koninklijke Philips NV
Xiaomi Corporation	Xiaomi
Hyundai Mobis Co Ltd	Hyundai Mobis
Hennes & Mauritz AB	H&M
Kraft Heinz	Kraft Heinz Company
BMW	Bayerische Motoren Werke AG
Texas Instruments	Texas Instruments Inc
The Walt Disney Company	Walt Disney
Microsoft Corp	Microsoft
Nintendo	Nintendo Co Ltd
Twitter	Twitter Inc
Acer	Acer, Inc.
Japan Airlines (JAL)	Japan Airlines Co. Ltd
British Petroleum (BP)	BP INTERNATIONAL LIMITED
China Eastern Airlines Corporation Limited	China Eastern Airlines
China Construction Bank	China Construction Bank Corporation
Taiwan Mobile	Taiwan Mobile Co Ltd
Hana Financial Group	Hana
Chevron Corporation	Chevron
Dior	Christian Dior SE
General Dynamics Corporation	General Dynamics
Truist Financial	Truist Financial Corporation
Safran SA	Safran
Monster Beverage Corporation	Monster Beverage
Workday	Workday Careers
Infineon	Infineon Technologies
Kinder Morgan	Kinder Morgan Inc
Muyuan Foods	Muyuan Foodstuff
Japan Tobacco	Japan Tobacco Inc
Warner Bros. Discovery Inc	Warner Bros. Discovery
Extra Space Storage	Extra Space Storage Inc
Nu Holdings Ltd.	Nu Holdings
First Solar	First Solar Inc
Swiss Life	Swiss Life Holding
Amundi SA	Amundi
Ionis Pharmaceuticals, Inc.	Ionis Pharmaceuticals
Apartment Income REIT Corp.	Apartment Income Reit
Option Care Health, Inc.	Option Care Health
Spectrum Brands Holdings Inc	Spectrum Brands
Kennedy-wilson Holdings	Kennedy Wilson
Wolverine World Wide	Wolverine World Wide Inc
MRC Global Inc	Mrc Global
Creepy Jar SA	Creepy Jar
Castellum	Castellum Ab (publ)
Hexo	HEXO Corp.
Schnitzer Steel Industries, Inc.	Schnitzer Steel
Grendene	Grendene SA
Everbridge	EVERBRIDGE, INC.
Dormakaba	dormakaba Holding AG
Ingles Markets Inc	Ingles Markets
Renasant Corporation	Renasant Corp
Korea Gas Corporation	Korea Gas
Corbion	Corbion N.V.
Lundin Gold Inc.	Lundin Gold
Arch Resources Inc	Arch Resources
Varonis Systems	Varonis
Atlas Air Worldwide Holdings	Atlas Air Worldwide Holdings Inc
HP Inc.	HP
HP Inc.	Hewlett Packard Enterprise Company
HP	Hewlett Packard Enterprise Company
New China Life Insurance	New China Life Insurance Company
Saudi Arabian Mining	Saudi Arabian Mining Company (ma'aden)
Mindmaze	MindMaze
OVH	OVH Groupe SAS
Joincare Pharmaceutical Group Industry	Joincare Pharmaceutical Group Industry Co.,Ltd.
JL Mag Rare-Earth Co. Ltd	Jl Mag Rare-earth
Leyard Optoelectronic	Leyard Optoelectronic Co. Ltd
Wonders Information Co. Ltd	Wonders Information
Haohua Chemical Science & Technology	Haohua Chemical Science & Technology Corp Ltd
Mekonomen AB	Mekonomen Ab (publ)
Nayax Ltd.	Nayax Ltd
Kajima Corp	Kajima Corporation
Taiheiyo Cement Corp	Taiheiyo Cement Corporation
Nippon Electric Glass	Nippon Electric Glass Co., Ltd.
Kokuyo	Kokuyo Co. Ltd
Shikoku Electric Power Co Inc	Shikoku Electric Power Company, Inc.
United Super Markets Holdings	United Super Markets Holdings, Inc.
Nec Networks & System Integration Corporation	NEC Networks & System Integration Corp
Jubilee Enterprise Public Company Ltd	Jubilee Industries Holdings Ltd
Nanofilm Technologies International	Nanofilm Technologies International Ltd
PT Hanjaya Mandala Sampoerna Tbk	Hanjaya Mandala Sampoerna Tbk PT
Deutsche Bank Spa	Deutsche Bank AG
Prada S.p.A.	Prada
Applegreen	Applegreen plc
C&C Group plc	C&C Group
Service Stream Limited	Service Stream Ltd
Ternium Argentina	Ternium Argentina SA
Essentra	Essentra plc
JPMorgan Global Growth & Income plc	Jpmorgan Global Growth & Income
Blackrock Throgmorton Trust	BlackRock Throgmorton Trust plc
Centamin	Centamin plc
Cheniere Energy, Inc.	Cheniere Energy Partners LP
Booz Allen Hamilton Holding	Booz Allen Hamilton Holding Corporation
Zynga	Zynga Inc.
Royal Gold	Royal Gold, Inc.
Under Armour, Inc.	Under Armour
Reinsurance Group of America	Reinsurance Group of America, Incorporated
Divido Financial Services	Divido
BITTNET	Bittnet Systems
Ashtead Group	ASHTEAD GROUP PUBLIC LIMITED COMPANY
Spotify Technology	Spotify Technology SA
Jil Sander	JIL SANDER SPA
Edison	Edison S.p.a
Getac Holdings Corp	Getac Technology Corporation
Alkermes	Alkermes Plc
Fox Factory Holding	Fox Factory Holding Corp
Elite Material Co Ltd	Elite Material
GC Corp	Green Cross Holdings Corporation
North China Pharmaceutical Company. Ltd	North China Pharmaceutical Co Ltd
Semapa - Sociedade De Investimento E Gestao Sgps	Semapa Sociedade de Investimento e Gestao SGPS SA
Sociedad Quimica y Minera de Chile SA	Sociedad Quimica Y Minera De Chile
Xilinx	Xilinx Inc
Shanghai Maling Aquarius	Shanghai Maling Aquarius Co Ltd
Jizhong Energy Resources	Jizhong Energy Resources Co Ltd
Wustenrot & Wurttembergische AG	Wustenrot & Wurttembergische Ag
Accenture Plc	ACCENTURE (UK) LIMITED
Aac Technologies Holdings	ALL ABOUT CRAFTS TRADE LIMITED
Aac Technologies Holdings	ALL ABOUT CRAFTS LIMITED
Aac Technologies Holdings	AAC TECHNOLOGIES HOLDINGS INC
ALL ABOUT CRAFTS TRADE LIMITED	ALL ABOUT CRAFTS LIMITED
ALL ABOUT CRAFTS TRADE LIMITED	AAC TECHNOLOGIES HOLDINGS INC
ALL ABOUT CRAFTS LIMITED	AAC TECHNOLOGIES HOLDINGS INC
AMAZON.COM SERVICES LLC	Amazon.com
VEOLIA NORTH AMERICA, LLC	VEOLIA NORTH AMERICA, INC.
